%%%%%%%%%%%%%%
%           P%
%     %%%%%%%%
%           G%
%  G         %
%            %
%       G    %
%            %
%%%%%%%%%%%%%%
% % % %%%%%%%%
%%%%%%%%%%%%%%
