%%%%%%%%%%%%%%
%G           %
%            %
%            %
%            %
%            %
%            %
%   P        %
%%%%%%%%%%%%%%
% %%%%%%%%%%%%
%%%%%%%%%%%%%%
