%%%%%%%%%%%%%%
%G    G      %
%            %
%       G    %
%            %
%            %
%            %
%           P%
%%%%%%%%%%%%%%
% % % %%%%%%%%
%%%%%%%%%%%%%%
