%%%%%%%%%%%%%%
%           P%
%            %
%    G       %
%G           %
%            %
%%%%%%%      %
%G           %
%%%%%%%%%%%%%%
% % % %%%%%%%%
%%%%%%%%%%%%%%
