%%%%%%%%%%%%%%
%G           %
%            %
%            %
%            %
%            %
%            %
%   P        %
%%%%%%%%%%%%%%
% % % % %%%%%%
%%%%%%%%%%%%%%
