%%%%%%%%%%%%%%
%G           %
%            %
%        P   %
%            %
%            %
% G          %
%          G %
%%%%%%%%%%%%%%
% % % %%%%%%%%
%%%%%%%%%%%%%%
