%%%%%%%%%%%%%%
%G           %
%%%%%%%%     %
%   G        %
%            %
%     G      %
%            %
%P           %
%%%%%%%%%%%%%%
% % % %%%%%%%%
%%%%%%%%%%%%%%
