%%%%%%%%%%%%%%
%G          G%
%%%%%%%%     %
%            %
%            %
%            %
%       G    %
%           P%
%%%%%%%%%%%%%%
% % % %%%%%%%%
%%%%%%%%%%%%%%
